11111111111111111111111111
10000000000001000000000E11
111000C0000001000001111111
1000000000000000000000C001
1000000100001P100000000001
10001111110110111000000001
1C000000000000000000001001
10000100000010000000001001
10000000000000000000001001
10000001000001000001111001
100000000000000000000000C1
11111111111111111111111111