11111111111111111111111111
100000000000010000E0000001
111000C0000001000001111111
1000000000000000000000C001
1000000100001P100000000001
10001111110110111000000001
1C000010000000000000000001
10000100000000000000000001
10000000000001001110000001
10111001101011100100000001
100000000000000000000000C1
11111111111111111111111111