11111111111
10000C00001
1CCCCCCCCC1
10P0010C001
10000000001
100E0000001
11111111111