11111111111
10000000001
1CCCCCCC001
1CP00100001
100E0000001
10000000001
11111111111