11111111111
100000000V1
1CCCCCCC001
1CP00100001
100E0000001
10000V00001
11111111111