111111111111
10000000V011
111100E00001
1P000000C001
100001001001
111111111111